/collection/object/imagefile/@filename	mods:identifier[@mods:type='local']/rdf:value
/collection/object/imagefile/titleInfo	mods:titleInfo
/collection/object/imagefile/titleInfo/title	mods:title
/collection/object/imagefile/typeOfResource	mods:typeOfResource
/collection/object/imagefile/originInfo/publisher	mods:origininfo/mods:publisher
/collection/object/imagefile/name	mods:name
/collection/object/imagefile/name/@type	@mods:type
/collection/object/imagefile/name/@authority	@mods:authority
/collection/object/imagefile/name/namePart	mods:namePart
/collection/object/imagefile/name/namePart/@type	@mods:type
#/collection/object/imagefile/mix/ImageCreation	mix:ImageCreation
/collection/object/imagefile/mix/ImageCreation/SourceType	mix:SourceType
/collection/object/imagefile/mix/ImageCreation/ImageProducer	mix:ImageProducer
/collection/object/imagefile/mix/ImageCreation/DeviceSource	mix:DeviceSource
#/collection/object/imagefile/mix/ImageCreation/ScanningSystemCapture	mix:ScanningSystemCapture
/collection/object/imagefile/mix/ImageCreation/ScanningSystemCapture/ScanningSystemHardware/ScannerManufacturer	mix:ScannerManufacturer
#/collection/object/imagefile/mix/ImageCreation/ScanningSystemCapture/ScanningSystemHardware/ScannerModel	mix:ScannerModel
/collection/object/imagefile/mix/ImageCreation/ScanningSystemCapture/ScanningSystemHardware/ScannerModel/ScannerModelName	mix:ScannerModelName
#/collection/object/imagefile/mix/ImageCreation/ScanningSystemCapture/ScanningSystemHardware	mix:ScanningSystemHardware
#/collection/object/imagefile/mix/ImageCreation/ScanningSystemCapture/ScannerModel	mix:ScannerModel
/collection/object/imagefile/mix/ImageCreation/ScanningSystemCapture/ScannerModel/ScannerModelName	mix:ScannerModelName
#/collection/object/imagefile/mix/ImageCreation/ScanningSystemCapture/ScanningSystemSoftware	mix:ScanningSystemSoftware
/collection/object/imagefile/mix/ImageCreation/ScanningSystemCapture/ScanningSystemSoftware/ScanningSoftware	mix:ScanningSoftware
/collection/object/imagefile/mix/ImageCreation/ScanningSystemCapture/ScanningSystemSoftware/ScanningSoftwareVersionNo	mix:ScanningSoftwareVersionNo
